000000000000000
000000000000000
000000000000000
000000000000000
100000000111110
000000000000000
000000000000000
000000000000000
003400022220022
005600000000000
005600000000000
005600000000000
777777777777777